!string: A Арена
!nobattle: 0
         A
#############################
#                           #
#                           #
#                           #
#                           #
#                           #
#                           #
#           @               #
#                           #
#                           #
#                           #
#                           #
#                           #
#############################