!string: A CaveGame tech demo
!nobattle: 1
!trigger: B   dialog techdemodiag1.diag
!trigger: C # map second

         A
########################################
#                                      #
#                                      #
#                                      #
#                                      #
#                                      #
#                                      #
#                                      #
#                                      ##############
#                 @                       B        C#
#                                      ##############
#                                      #
#                                      #
#                                      #
#                                      #
#                                      #
#                                      #
########################################